New creature data sent to terminal!=Данные о новом персе Слендиромы отправлены на терминал!
Bunker spider=Бункерный баиден
Snare flea=Леха Fougy
Circuit bees=Беги форест беги
Centipede=Ника
Manticoil=Какая-то хуня
Roaming locusts=Какая-то мелкая хуня
Eyeless dog=Найджел
Spore lizard=Елена Андреевна
Forest Giant=Баскетболист 212см
Forest keeper=Баскетболист 212см
Hoarding bug=All my fellas
Hygrodere=Бловджоб
Earth leviathan=Член Демократии
Baboon hawk=Светлана ОРКадьевна
Bracken=Адилет
Flowerman=Адилет
Coil-head=SCP-173
Jester=Мудила
Thumper=Топтун
Half=Половинчатый
Turret=NON-CUTE Турель
Ghost girl=Аня Тушева
Nutcracker=Щелкунчик
Masked=Подражатель
Lasso=Лассо
Tulip Snake=Тюльпановая змея
Butler=Дворецкий
Old Bird=Старинная птица
Landmine=Коровья мина