Airhorn=Звуки стонов
Ammo=Патрон
Apparatus=Генератор
Bee hive=Беги Форест Беги
Big bolt=БигБолт Моти
Bottles=Ящик водяры
Brass bell=Медный колокол
Brush=Расческа Ирины Николаевны
Candy=Сосун
Cash register=Кассовый аппарат
Chemical jug=Баллон метиламина
Clown horn=Клоунский клаксон
Coffee mug=Кружка Федотова
Comedy=Маска "КВН"
Cookie mold pan=Форма для выпечки
Double-barrel=Дробовик Курт Кобейна
Dust pan=Совок для пыли
Egg beater=Венчик
Fancy lamp=Причудливая лампа
Flask=Колба с красным льдом
Gift box=Steam Gift
Gold bar=Золотой слиток
Golden cup=Кубок "Золотого Окурка"
Hair brush=Расческа Ирины Николаевны
Hairdryer=Брось в ванну с сестрой
Hive=Пчелиное гнездо
Homemade Flashbang=Pornhub Light Theme
Jar of pickles=Огурцы Копатыча
Key=Ключ
Large axle=Большая песда
Laser pointer=Лазерная указка
Magic 7 ball=Магический шар 
Magnifying glass=TheLUPA
Metal sheet=Лист металла
Mug=Кружка
Old phone=Старый Nokia1489MeltyBlood_ФУНКЦИЯ С ОТЦОМ_PLANETVPN_мочa)
Painting=Портрет Адольфа Гитлера
Perfume bottle=Духи Маргариты Витальевны
Pill bottle=Антидепрессанты
Plastic fish=Пластмассовая пизда
Player Body=Труп-Спермоприемник
Red soda=Добрый Кола
Remote=Пульт
Robot Toy=Робот Долбаеб
Toy Robot=Робот Долбаеб
Rubber ducky=Сучка драная
Steering wheel=Руль
Stop sign=Знак "СТОП ГИТЛЕР"
Shotgun shell=Патрон для дробовика Курт Кобейна
Tattered metal sheet=Рваный лист для подтирания жопы
Tea Kettle=Кирилл
Teeth=Челюсть Ойрех
Toothpaste=Зубная паста цвета гавна
Toy cube=Ты че тетрис чтоли
Tragedy=Маска "Comedy Woman"
V-type engine=Огромная шняга ZOV
Wedding ring=Обручальное кольцо Путина
Whoopie cushion=Подушка-пердушка
Yield sign=Знак "УСТУПИ ДОРОГУ НАЦИСТУ"
Easter egg=Яичко главы РПЦ
Kitchen knife=Нож
Soccer ball=Я - Футбольный мячик!
Toilet paper=Туалетка из фикспрайса